  ####   
###  ####
#     + #
# #  #+ #
# @ @#I #
#########
