#############
#@# I#  #   #
#@#++   # + #
#@#  # +#   #
#@# +#  # +##
#@#  # +#  # 
#@# +#  # +# 
#@@  # +   # 
#@@  #  #  # 
############ 
