    ######               #### 
#####*#  #################  ##
#   ###                      #
#        ########  ####  ##  #
### ####     #  ####  ####  ##
#*# # @# # # #     #     #   #
#*# #  #     # ##  # ##  ##  #
###    ### ###  # ##  # ##  ##
 #   # #*#      #     # #    #
 #   # ###  #####  #### #    #
 #####   #####  ####### ######
 #   # # #**#               # 
## # #   #**#  #######  ##  # 
#    #########  #    ##### ###
# #             # +        #*#
#   #########  ### I#####  #*#
#####       #### ####   ######
