######
#    #
# #I #
# +* #
# @* #
#    #
######
