  ###########  
 ##    #    ## 
### + +#+ + ###
# #+ + # + +# #
# +  @@#@@  + #
#  +@@@#@@@+  #
# + @@ * @@ + #
###### I ######
# + @@   @@ + #
#  +@@@#@@@+  #
# +  @@#@@  + #
# #+ + # + +# #
### + +#+ + ###
 ##    #    ## 
  ###########  
