#############
# I         #
#@   +      #
#@      +   #
#           #
#############
