#############
# I         #
#@   +      #
#@      +   #
#*          #
#############
